Class1	待删除
Class2	待删除
Class3	待删除
ReplaceableUnit	待删除
SubClass1	待删除
UidButton	邓威威
DftItem	邓威威
DftVersion	邓威威
CPLDSelftest	邓威威
Led	邓威威
LedTest	邓威威
LDAPGroup	顾叶龙
PortConfig	顾叶龙
LDAP	顾叶龙
EthGroup	顾叶龙
Eth	顾叶龙
LogicalEth	顾叶龙
FruDev	何军
Elabel	何军
Fru	何军
Accessor	何军
Chip	何军
Bus	何军
Eeprom	何军
I2c	何军
Gpio 	何军
LocalBus	何军
OscaPcieCard	何军
HDDBackplane	何军
Raid	何军
BusinessPort	顾叶龙
OscaPort	何军
Jtag	何军
Cpu	何军
Memory	何军
Hdd	何军
InternalBus	何军
Anchor	何军
AdcBus	李诚
I2CDevTest	李诚
Log	李诚
Dump	李诚
ScriptEngine	李诚
Monitor	李诚
VoltMonitor	李诚
ThresholdAssert	李诚
TempMonitor	李诚
VddqTempChip	李诚
VddqTempDevTest	李诚
AdcDevTest	李诚
VoltTest	李诚
LedDispElmt_S	李诚
BMC	齐成明
Contact	齐成明
Bios	齐成明
SmBios	齐成明
Upgrade	齐成明
PRODUCT	齐成明
BOARD	齐成明
Connector	何军
Hotswap	谢敏旭
FruPayload	谢敏旭
ChassisPayload	谢敏旭
Watchdog2	谢明旭
Vmm	殷鑫
KvmLink	殷鑫
Video	殷鑫
Kvm	殷鑫
Diagnose	殷鑫
ThresholdSensor	郑根强
DiscreteSensor	郑根强
DeaSdr	郑根强
McdlSdr	郑根强
DiscreteEvent	郑根强
EventDescp	郑根强
SelFilter	郑根强
PefFilter	郑根强
AlertFilter	郑根强
SmtpConfig	郑根强
TrapConfig	郑根强
Sel	郑根强
Warning	郑根强
Entity	郑根强
SmtpItemCfg	郑根强
TrapItemCfg	郑根强
LedTubeData	郑根强
SdrDev	郑根强
PcieCard	郑根强
UserChannelPrivilege	周文
User	周文
PasswdSetting	周文
DNSSetting	周文
Session	周文
SysPower	周羽波
OnePower	周羽波
PowerCapping	周羽波
CfgMgnt	周羽波
PsuSlot	周羽波
Ina220	周羽波
SerialPort	宗明理
IPMIChannel	宗明理
RmcpConfig	宗明理
Com	宗明理
IpmbEth	邹榕榕
Ipmb	邹榕榕
Pwm	邹榕榕
Fantech	邹榕榕
Cooling	邹榕榕
FANClass	邹榕榕
CpuPowTempMap	邹榕榕
Policy1Class	邹榕榕
CoolingCondition	邹榕榕
BladeCpuThermal	邹榕榕
BladeCoolingPolicy	邹榕榕